111111111111
100000PCOE11
1000000O0001
111111111111
