111111111111111
1000000PCE00001
1000000O0000001
111111111111111
