1111111111111111111111111111111111111111111111111111
1000000000000000000000000000000000000000000000000001
1000000000000000000000000000000000000000000000000001
1000000000000000000001000011111100000000000000000001
10000000000000000000000C0000000000000000000000000001
100000000000CC00001C10000000000000000000000000000001
1000000000000000000000000000000000000000000000000001
1000000000000000000000000000000000000000000000000001
100000000000010000000000000E000000000000000000000001
10000000000010000C0000000000000000000000000000000001
1000000000000000000000000000000000000000000000000001
1000000000000000000000000000000000000000000000000001
1000000000000000000000000P00000000000000000000000001
1000000000000000000000000000000000000000000000000001
1111111111111111111111111111111111111111111111111111
