111111111111111111111111111111111111
100000000000000000000000000000000001
1E000000000000000P000000000000000001
1C1000000000000000000000000000001111
111111111111111111111111111111111111
