111111111111111111111111111111111111
1C0000000000000000000000000000000001
1E000000000000000P000000000000000001
101000000000000000000000000000001111
111111111111111111111111111111111111
